5 10
RRRR......
...R......
RRRCRCRCRR
.....R.R.R
RRRRRR.RRR